S....B..BBBBBBBBBBBBBBB..B.....
....TB...B.....T.....B..TB.....
RRRRR#RRRR#RRRRRRRRR#RRRR#RRRRR
.....#.....BT..R...B.....#T....
.....#......B..R..B......#.....
.....#...O...B.R.B...@...#.....
.....#........BRB........#.....
....RBR........#........RBR....
...R.B.R......BRB......R.B.R...
..R..B..R....B.R.B....R..B..R..
.R..@B..TR..B..R..B..RT..BO..R.
RRRRR#RRRRRBT..R..TBRRRRR#RRRRR
....T#....B....#....B....#T....
.....#...B....###....B...#.....
.....#..BBBBB#####BBBBBT.#....E