.....R....R....R....R....R....E
.....R....R....R....R....R.....
....TR....R....R....R....R.....
BBBBB#BBBB#BBBB#BBBB#BBBB#BBBBB
.....RT...R....R....R....R.....
.....R....R....R....R....R.....
.....R....R....R....R...TR.....
BBBBB#BBBB#BBBB#BBBB#BBBB#BBBBB
T....R....R....R....R....R.....
.....R....R....R....R....R.....
.....R....R....R....RT...R.....
BBBBB#BBBB#BBBB#BBBB#BBBB#BBBBB
.....R...TR....R....R....R.....
.....R....R....R....R....R.....
S....R....R....R....R....R.....