E....R....R....R....R....R.....
.....R.@..R....R....R.O..R.....
.....R....R....R....R....R.....
BBBBB#BBBB#BBBB#BBBB#BBBB#BBBBB
.....R....R....RT...R....R.....
.....R....R....R....R....R.....
.....R....RT...R....R....R....T
BBBBB#BBBB#BBBB#BBBB#BBBB#BBBBB
.....R....R....R....R....R.....
.....R....R....R.@..R....R..O..
.....R....R....R....RT...R.....
BBBBB#BBBB#BBBB#BBBB#BBBB#BBBBB
.....RT...R....R...TR....R.....
.....R....R....R....R....R.....
S....R....R....R....R....R.....