.....B..BBBBBBBBBBBBBBB..B....S
.....BT..B.....T.....B..TB.....
RRRRR#RRRR#RRRRRRRRR#RRRR#RRRRR
.....#..T..BT..R..TB.....#.....
.....#......B..R..B......#.....
.....#.......B.R.B.......#.....
.....#........BRB........#.....
....RBR........#........RBR....
...R.B.R......BRB......R.B.R...
..R..B..R....B.R.B....R..B..R..
.RT..B..TR..B..R..B..RT..B..TR.
RRRRR#RRRRRBT..R..TBRRRRR#RRRRR
.....#....B....#....B....#.....
.....#...B....###....B...#.....
E....#..BBBBB#####BBBBB..#.....